11111111111111
1000C00C00P001
10P00C00000001
1E00000C000001
11111111111111