11111111111
1P0E1 10001
10C01 10001
11111111111