11111111111111
1000000000P001
10001111100001
1E001111100001
11111111111111