11111111111111
10000000C0C001
100C1111100001
1C001111100001
11111111111111