11111111111111
1C00000000P1
100011111001
1E001111100C01
11111111111111