111111111111
1P00C0000001
100111101111
100C10000C01
1000100010E1
111111111111