111111111111
1P00C0000001
1001111C1111
100C00CECC01
1000100C0011
111111111111