111111111111
1P0000000001
100000011111
100C00010001
1000000110E1
111111111111