111111111111
1P0000000001
1001111C1111
100C00CECC01
1000111C0011
111111111111