11111111111111111111111111111111111
1P000000000000000000000000000000001
100100C0111111100C001111111000C0111
10000000100000100000100000000000101
10010000C000001000001000C0100000001
10011111100000111111100000111111101
10010000101111100000111111100000111
10010C001000000C0000100000000C00101
10000000100000100000000E00100000101
1001111110C000111111100C00101111101
10011111100000111111100000111111101
10000C00000000000000000000000000001
10000000000000000000000000000000001
1001111110C000111111100C00101111101
10011111100000111111100000111111101
10000C00000000000000000000000000001
11111111111111111111111111111111111