1111111111111111111111111111
10000000C0C001111110000000E1
100C1111100000011111000C0010
1000000011111000000000000111
1P0011111000C0111110C0111111
1111111111111111111111111111